5 13 31
###############################
#p * *3       *  ** * * s    *#
# # # # #*# # #*# # # # # #*# #
#    * * *** **  5   *  b **  #
# #*#   *f*  4# #b#1# # # # #*#
#  f    *  *     **      *  **#
# # #*# # # # # #*#*#*#*# # # #
#   *        *   * *x*5*   4  #
# # # # #*# # # # # # #*# #*# #
#   ****       b *2           #
# # # # # # # # # #*# # # # #*#
#  ** *5  *    2     4        #
###############################