4 13 31
###############################
#p    * **    *   3   4       #
#   #####    ### ###      # * #
#    *#*    #   #   #*    #*  #
# ** *#   * *#1  b2#      #  *#
#     #    *  #   #* f    # 2 #
#   #####   ***# #***     #####
#    *     *        *    **  3#
# #*# # #*#*#*#*# # #1# # #*# #
#   2    * 4 *2*    *   *     #
#*# # # # # # # # # # #*# # #*#
#x*    * **    ** ***     1   #
###############################