2 13 31
###############################
#p * *2       *  ** * *      *#
#   #####    ### ###      # * #
#    *#*    #   #   #*    #*  #
# ** *#   * *#1  b1#      #  *#
#     #    *  #   #* f    # 2 #
#   #####   ***# #***     #####
# s *        *  #* *x* *      #
# # # # #*# # # # # # #*# #*# #
#   ****      b  *1           #
# # # # # # # # # #*# # # # #*#
#  ** *   *    2              #
###############################