3 13 31
###############################
#p   ** **  f *   2           #
# # # #*# # # # # # # # # # # #
#*  1  ** * *  *   * ** 3 x   #
# # # # # #*# # # # # # #*# # #
#*   *s*    *** *   **        #
# # # # # # # # # # # # # #*# #
#    *     *        *    **  3#
# #*# # #*#*#*#*# # #1# # #*# #
#     b   *  *2*    *   *     #
#*# # # # # # # # # # #*# # #*#
# *    * **    ** ***   f 1   #
###############################