3 13 31
###############################
#p   ** **  f *   2      1    #
# # # #*# # # # # # # # # # # #
#*  1  ** * *  *   * ** 3 x   #
# # # # # #*# # # # # # #*# # #
#*   *s*    *** *4  **        #
# # # # # *** # # # # # # #*# #
#    *3    *        *    **  3#
# #*# # #*#*#*#*# # #1# # #*# #
#     b   *  *2*    *   *     #
#*# # # # # # # # # # #*# # #*#
# *   4* **    ** ***   f 1   #
###############################