5 13 31
###############################
#p x *3       *  ** * * s 6  *#
# # # # #*# # #*# # # # # #*# #
#    * * *** **  5   *  b **  #
# #*#   *f*  4# #b#1# # # # #*#
#  f    *  *   5 **      *  **#
# # #*# # # # # #*#*#*#*# # # #
#   *        *   * *x*5*   4  #
# # # # #*# # # # # # #*# #*# #
#   ****    6  b *2           #
# # # # # # # # # #*# # # # #*#
#  ** *5  *    2     4        #
###############################